********************
**S*            *G**
**          e*******
**                **
*********   ****  **
*********         **
********************