********************
**S*             G**
**          e***  **
**                **
*********   ****  **
*********        G**
********************