********************
**S*           * G**
**          e***  **
**             *  **
*********   ****  **
*********   ****  **
*********   ****  **
*********   ****  **
*********   ****  **
*********    **   **
*********         **
********************