**********************************
**S      ****   ***          G  **
****     ****    E*    ***      **
*****  E ****         *****  *****
*****    *      **    E***  ******
***            ****            ***
****     *      **    ****  G ****
**      ***       G   ******    **
**********************************